YEAR,STATENAME,tax_property_hh,tax_property_business,tax_consumption_hh,tax_consumption_business,tax_income_total,tax_property_total,tax_consumption_total,state_population,tax_property_hh_pc,tax_property_business_pc,tax_consumption_hh_pc,tax_consumption_business_pc,tax_income_total_pc,tax_property_total_pc,tax_consumption_total_pc
2005,Alabama,592390000,1200000000,2757142000,2400000000,2644726000,1792390000,5157142000,4569805,130,263,603,525,579,392,1129
2005,Alaska,192307000,700000000,203209000,100000000,0,892307000,303209000,666946,288,1050,305,150,0,1338,455
2005,Arizona,1538201000,3400000000,4579734000,3700000000,2848450000,4938201000,8279734000,5839077,263,582,784,634,488,846,1418
2005,Arkansas,258532000,900000000,2648023000,1400000000,1875065000,1158532000,4048023000,2781097,93,324,952,503,674,417,1456
2005,California,15969509000,18100000000,20843459000,24600000000,42992007000,34069509000,45443459000,35827943,446,505,582,687,1200,951,1268
2005,Colorado,2242190000,2700000000,2500004000,2800000000,3770736000,4942190000,5300004000,4631888,484,583,540,605,814,1067,1144
2005,Connecticut,4755644000,2400000000,1979944000,2300000000,5033442000,7155644000,4279944000,3506956,1356,684,565,656,1435,2040,1220
2005,Delaware,285848000,200000000,49902000,200000000,932254000,485848000,249902000,845150,338,237,59,237,1103,575,296
2005,District of Columbia,435527000,700000000,443254000,600000000,1147940000,1135527000,1043254000,567136,768,1234,782,1058,2024,2002,1840
2005,Florida,9991910000,10400000000,13753613000,14000000000,0,20391910000,27753613000,17842038,560,583,771,785,0,1143,1556
2005,Georgia,3714553000,4500000000,4341271000,5000000000,7326225000,8214553000,9341271000,8925922,416,504,486,560,821,920,1047
2005,Hawaii,218239000,600000000,1507333000,1100000000,1381481000,818239000,2607333000,1292729,169,464,1166,851,1069,633,2017
2005,Idaho,454118000,700000000,923222000,500000000,1040512000,1154118000,1423222000,1428241,318,490,646,350,729,808,996
2005,Illinois,8411680000,9900000000,5554355000,8100000000,7936884000,18311680000,13654355000,12609903,667,785,440,642,629,1452,1083
2005,Indiana,3002586000,5300000000,4013172000,2200000000,4811592000,8302586000,6213172000,6278616,478,844,639,350,766,1322,990
2005,Iowa,1002317000,2300000000,1761525000,1000000000,2312898000,3302317000,2761525000,2964454,338,776,594,337,780,1114,932
2005,Kansas,1005500000,2100000000,1727080000,1600000000,2079782000,3105500000,3327080000,2745299,366,765,629,583,758,1131,1212
2005,Kentucky,946867000,1300000000,1442577000,2000000000,3792231000,2246867000,3442577000,4182742,226,311,345,478,907,537,823
2005,Louisiana,529386000,1900000000,2222737000,4400000000,2392727000,2429386000,6622737000,4576628,116,415,486,961,523,531,1447
2005,Maine,851968000,1300000000,793927000,500000000,1299252000,2151968000,1293927000,1318787,646,986,602,379,985,1632,981
2005,Maryland,2094371000,3500000000,1803767000,2600000000,9153415000,5594371000,4403767000,5592379,375,626,323,465,1637,1000,787
2005,Massachusetts,5141126000,5200000000,2769357000,2300000000,9690270000,10341126000,5069357000,6403290,803,812,432,359,1513,1615,792
2005,Michigan,6519239000,6400000000,7484822000,3100000000,6565176000,12919239000,10584822000,10051137,649,637,745,308,653,1285,1053
2005,Minnesota,1150876000,4100000000,2236277000,3000000000,6341164000,5250876000,5236277000,5119598,225,801,437,586,1239,1026,1023
2005,Mississippi,467447000,1500000000,1770262000,1400000000,1174065000,1967447000,3170262000,2905943,161,516,609,482,404,677,1091
2005,Missouri,2395477000,2300000000,2932236000,3200000000,4318505000,4695477000,6132236000,5790300,414,397,506,553,746,811,1059
2005,Montana,296463000,700000000,103937000,200000000,713390000,996463000,303937000,940102,315,745,111,213,759,1060,323
2005,Nebraska,794637000,1300000000,1032451000,1200000000,1393897000,2094637000,2232451000,1761497,451,738,586,681,791,1189,1267
2005,Nevada,1020774000,1300000000,1966854000,1900000000,0,2320774000,3866854000,2432143,420,535,809,781,0,954,1590
2005,New Hampshire,1350326000,1300000000,15475000,300000000,67686000,2650326000,315475000,1298492,1040,1001,12,231,52,2041,243
2005,New Jersey,12596599000,6600000000,4677617000,4300000000,9537939000,19196599000,8977617000,8651974,1456,763,541,497,1102,2219,1038
2005,New Mexico,369915000,500000000,1119259000,1400000000,1086015000,869915000,2519259000,1932274,191,259,579,725,562,450,1304
2005,New York,16449967000,17700000000,9586509000,14800000000,34843704000,34149967000,24386509000,19132610,860,925,501,774,1821,1785,1275
2005,North Carolina,3249622000,3200000000,4304133000,3900000000,8427553000,6449622000,8204133000,8705407,373,368,494,448,968,741,942
2005,North Dakota,120114000,500000000,268372000,400000000,242008000,620114000,668372000,646089,186,774,415,619,375,960,1034
2005,Ohio,5273977000,6700000000,6581147000,5600000000,13079167000,11973977000,12181147000,11463320,460,584,574,489,1141,1045,1063
2005,Oklahoma,618634000,1100000000,1661747000,2000000000,2468609000,1718634000,3661747000,3548597,174,310,468,564,696,484,1032
2005,Oregon,1761698000,1800000000,425448000,400000000,4829181000,3561698000,825448000,3613202,488,498,118,111,1337,986,228
2005,Pennsylvania,7090472000,6300000000,6677772000,5900000000,11461650000,13390472000,12577772000,12449990,570,506,536,474,921,1076,1010
2005,Rhode Island,919413000,900000000,610794000,600000000,998042000,1819413000,1210794000,1067916,861,843,572,562,935,1704,1134
2005,South Carolina,1238818000,2500000000,2312350000,1500000000,2691473000,3738818000,3812350000,4270150,290,585,542,351,630,876,893
2005,South Dakota,136262000,600000000,515013000,500000000,0,736262000,1015013000,775493,176,774,664,645,0,949,1309
2005,Tennessee,1094539000,2800000000,5386834000,3400000000,155333000,3894539000,8786834000,5991057,183,467,899,568,26,650,1467
2005,Texas,10589045000,19700000000,9606975000,16600000000,0,30289045000,26206975000,22778123,465,865,422,729,0,1330,1151
2005,Utah,892458000,900000000,1557653000,1200000000,1926697000,1792458000,2757653000,2457719,363,366,634,488,784,729,1122
2005,Vermont,456355000,600000000,179616000,300000000,500464000,1056355000,479616000,621215,735,966,289,483,806,1700,772
2005,Virginia,4590045000,3800000000,2505960000,3500000000,8352366000,8390045000,6005960000,7577105,606,502,331,462,1102,1107,793
2005,Washington,3632143000,3000000000,5159158000,7800000000,0,6632143000,12959158000,6257305,580,479,825,1247,0,1060,2071
2005,West Virginia,108420000,900000000,820730000,900000000,1171987000,1008420000,1720730000,1820492,60,494,451,494,644,554,945
2005,Wisconsin,3996015000,3800000000,3700525000,2200000000,5465082000,7796015000,5900525000,5546166,721,685,667,397,985,1406,1064
2005,Wyoming,164483000,700000000,297328000,500000000,0,864483000,797328000,514157,320,1361,578,972,0,1681,1551
2005,United States Total,152979002000,182800000000,164115861000,175400000000,242273042000,335779002000,339515861000,295516599,518,619,555,594,820,1136,1149
2006,Alabama,613562000,1300000000,3063380000,2500000000,2876442000,1913562000,5563380000,4628981,133,281,662,540,621,413,1202
2006,Alaska,69186000,900000000,240459000,100000000,0,969186000,340459000,675302,102,1333,356,148,0,1435,504
2006,Arizona,2094205000,3800000000,5508523000,4300000000,3253279000,5894205000,9808523000,6029141,347,630,914,713,540,978,1627
2006,Arkansas,416614000,900000000,2750178000,1600000000,2012835000,1316614000,4350178000,2821761,148,319,975,567,713,467,1542
2006,California,23746062000,19700000000,20096646000,28300000000,51219823000,43446062000,48396646000,36021202,659,547,558,786,1422,1206,1344
2006,Colorado,2213605000,3100000000,2821390000,3000000000,4258944000,5313605000,5821390000,4720423,469,657,598,636,902,1126,1233
2006,Connecticut,4867866000,2700000000,1743889000,2200000000,5777636000,7567866000,3943889000,3517460,1384,768,496,625,1643,2152,1121
2006,Delaware,230764000,300000000,67998000,200000000,1076552000,530764000,267998000,859268,269,349,79,233,1253,618,312
2006,District of Columbia,413606000,800000000,553020000,500000000,1232384000,1213606000,1053020000,570681,725,1402,969,876,2159,2127,1845
2006,Florida,11534925000,11600000000,17826201000,15300000000,0,23134925000,33126201000,18166990,635,639,981,842,0,1273,1823
2006,Georgia,3783608000,5100000000,5769355000,5300000000,8040366000,8883608000,11069355000,9155813,413,557,630,579,878,970,1209
2006,Hawaii,382653000,600000000,1554238000,1300000000,1550757000,982653000,2854238000,1309731,292,458,1187,993,1184,750,2179
2006,Idaho,434748000,800000000,888838000,500000000,1222569000,1234748000,1388838000,1468669,296,545,605,340,832,841,946
2006,Illinois,8316283000,11200000000,6381409000,8200000000,8635104000,19516283000,14581409000,12643955,658,886,505,649,683,1544,1153
2006,Indiana,1531161000,6000000000,4291828000,2300000000,5299485000,7531161000,6591828000,6332669,242,947,678,363,837,1189,1041
2006,Iowa,788882000,2600000000,1926996000,1000000000,2482891000,3388882000,2926996000,2982644,264,872,646,335,832,1136,981
2006,Kansas,867231000,2400000000,1935980000,1700000000,2402085000,3267231000,3635980000,2762931,314,869,701,615,869,1183,1316
2006,Kentucky,935367000,1500000000,1737816000,2100000000,3921908000,2435367000,3837816000,4219239,222,356,412,498,930,577,910
2006,Louisiana,269740000,2200000000,2626147000,5000000000,2501120000,2469740000,7626147000,4302665,63,511,610,1162,581,574,1772
2006,Maine,611708000,1400000000,866225000,600000000,1368927000,2011708000,1466225000,1323619,462,1058,654,453,1034,1520,1108
2006,Maryland,2461742000,3500000000,2126297000,2800000000,9847319000,5961742000,4926297000,5627367,437,622,378,498,1750,1059,875
2006,Massachusetts,4912163000,5900000000,2710361000,2500000000,10483437000,10812163000,5210361000,6410084,766,920,423,390,1635,1687,813
2006,Michigan,6456170000,7100000000,6838957000,3700000000,6698913000,13556170000,10538957000,10036081,643,707,681,369,667,1351,1050
2006,Minnesota,820204000,4500000000,2553115000,3200000000,6862953000,5320204000,5753115000,5163555,159,871,494,620,1329,1030,1114
2006,Mississippi,376719000,1700000000,2140285000,1500000000,1254733000,2076719000,3640285000,2904978,130,585,737,516,432,715,1253
2006,Missouri,2331131000,2600000000,2957232000,3200000000,4821082000,4931131000,6157232000,5842704,399,445,506,548,825,844,1054
2006,Montana,357609000,700000000,148332000,200000000,768911000,1057609000,348332000,952692,375,735,156,210,807,1110,366
2006,Nebraska,697262000,1500000000,906966000,1200000000,1545024000,2197262000,2106966000,1772693,393,846,512,677,872,1240,1189
2006,Nevada,1009147000,1500000000,2000564000,2100000000,0,2509147000,4100564000,2522658,400,595,793,832,0,995,1625
2006,New Hampshire,1380250000,1400000000,61343000,300000000,80931000,2780250000,361343000,1308389,1055,1070,47,229,62,2125,276
2006,New Jersey,13049427000,7500000000,4516893000,4700000000,10506565000,20549427000,9216893000,8661679,1507,866,521,543,1213,2372,1064
2006,New Mexico,354082000,600000000,1460310000,1400000000,1123954000,954082000,2860310000,1962137,180,306,744,714,573,486,1458
2006,New York,16441335000,20000000000,9753657000,15400000000,38611920000,36441335000,25153657000,19104631,861,1047,511,806,2021,1907,1317
2006,North Carolina,3285360000,3700000000,5617370000,4200000000,9467278000,6985360000,9817370000,8917270,368,415,630,471,1062,783,1101
2006,North Dakota,134291000,500000000,316242000,400000000,275630000,634291000,716242000,649422,207,770,487,616,424,977,1103
2006,Ohio,5115471000,7500000000,7721989000,5500000000,13529560000,12615471000,13221989000,11481213,446,653,673,479,1178,1099,1152
2006,Oklahoma,595801000,1200000000,1837097000,2200000000,2755776000,1795801000,4037097000,3594090,166,334,511,612,767,500,1123
2006,Oregon,1754685000,2000000000,506576000,400000000,5537385000,3754685000,906576000,3670883,478,545,138,109,1508,1023,247
2006,Pennsylvania,7025637000,7200000000,6953754000,6200000000,12326355000,14225637000,13153754000,12510809,562,576,556,496,985,1137,1051
2006,Rhode Island,887857000,1000000000,520571000,700000000,1019482000,1887857000,1220571000,1063096,835,941,490,658,959,1776,1148
2006,South Carolina,1182966000,2800000000,2384974000,1700000000,2727251000,3982966000,4084974000,4357847,271,643,547,390,626,914,937
2006,South Dakota,64495000,700000000,489728000,600000000,0,764495000,1089728000,783033,82,894,625,766,0,976,1392
2006,Tennessee,1028756000,3100000000,5760525000,3700000000,192764000,4128756000,9460525000,6088766,169,509,946,608,32,678,1554
2006,Texas,10226070000,22200000000,10499185000,18200000000,0,32426070000,28699185000,23359580,438,950,449,779,0,1388,1229
2006,Utah,867714000,1000000000,1807678000,1200000000,2277478000,1867714000,3007678000,2525507,344,396,716,475,902,740,1191
2006,Vermont,348488000,800000000,195319000,300000000,542012000,1148488000,495319000,622892,559,1284,314,482,870,1844,795
2006,Virginia,4933053000,4300000000,2910232000,3600000000,9073077000,9233053000,6510232000,7673725,643,560,379,469,1182,1203,848
2006,Washington,3478007000,3400000000,5877915000,8600000000,0,6878007000,14477915000,6370753,546,534,923,1350,0,1080,2273
2006,West Virginia,59055000,1000000000,856568000,900000000,1297720000,1059055000,1756568000,1827912,32,547,469,492,710,579,961
2006,Wisconsin,3716716000,4300000000,3464587000,2600000000,5906515000,8016716000,6064587000,5577655,666,771,621,466,1059,1437,1087
2006,Wyoming,185560000,800000000,421058000,500000000,0,985560000,921058000,522667,355,1531,806,957,0,1886,1762
2006,United States Total,159658999000,204900000000,178966196000,189700000000,268667132000,364558999000,368666196000,298379912,535,687,600,636,900,1222,1236
2010,Alabama,770648000,1800000000,3019407000,2800000000,2724059000,2570648000,5819407000,4785298,161,376,631,585,569,537,1216
2010,Alaska,475689000,800000000,413627000,100000000,0,1275689000,513627000,713985,666,1120,579,140,0,1787,719
2010,Arizona,2183618000,5000000000,4374297000,4300000000,2416324000,7183618000,8674297000,6413737,340,780,682,670,377,1120,1352
2010,Arkansas,843242000,900000000,2932560000,1500000000,2091082000,1743242000,4432560000,2921606,289,308,1004,513,716,597,1517
2010,California,23450526000,30300000000,24703098000,25900000000,45646436000,53750526000,50603098000,37349363,628,811,661,693,1222,1439,1355
2010,Colorado,2369242000,4500000000,3046925000,3200000000,4089948000,6869242000,6246925000,5049071,469,891,603,634,810,1360,1237
2010,Connecticut,6892989000,2300000000,1957164000,2400000000,5768846000,9192989000,4357164000,3577073,1927,643,547,671,1613,2570,1218
2010,Delaware,406469000,300000000,124317000,200000000,907253000,706469000,324317000,899769,452,333,138,222,1008,785,360
2010,District of Columbia,159126000,1700000000,431987000,700000000,1107139000,1859126000,1131987000,604453,263,2812,715,1158,1832,3076,1873
2010,Florida,7336839000,20800000000,13314890000,14700000000,0,28136839000,28014890000,18843326,389,1104,707,780,0,1493,1487
2010,Georgia,4162568000,6400000000,4971650000,5200000000,7016412000,10562568000,10171650000,9712587,429,659,512,535,722,1088,1047
2010,Hawaii,393152000,1000000000,1766613000,1300000000,1527790000,1393152000,3066613000,1363621,288,733,1296,953,1120,1022,2249
2010,Idaho,554234000,800000000,939365000,500000000,1068754000,1354234000,1439365000,1571450,353,509,598,318,680,862,916
2010,Illinois,10744587000,12900000000,4927819000,9000000000,9433245000,23644587000,13927819000,12843166,837,1004,384,701,734,1841,1084
2010,Indiana,2241801000,5400000000,4874733000,2600000000,5458567000,7641801000,7474733000,6490621,345,832,751,401,841,1177,1152
2010,Iowa,1427412000,2800000000,2190016000,1400000000,2746549000,4227412000,3590016000,3049883,468,918,718,459,901,1386,1177
2010,Kansas,1219132000,2700000000,1834642000,1900000000,2690505000,3919132000,3734642000,2859169,426,944,642,665,941,1371,1306
2010,Kentucky,994092000,2000000000,1629777000,2600000000,4206796000,2994092000,4229777000,4346266,229,460,375,598,968,689,973
2010,Louisiana,933367000,2500000000,1862873000,5300000000,2286500000,3433367000,7162873000,4544228,205,550,410,1166,503,756,1576
2010,Maine,658744000,1700000000,732464000,700000000,1303370000,2358744000,1432464000,1327567,496,1281,552,527,982,1777,1079
2010,Maryland,6198332000,2300000000,2256311000,3200000000,9924025000,8498332000,5456311000,5785982,1071,398,390,553,1715,1469,943
2010,Massachusetts,6573816000,6300000000,3255552000,2700000000,10128035000,12873816000,5955552000,6557254,1003,961,496,412,1545,1963,908
2010,Michigan,6659639000,7600000000,7016526000,4200000000,5913526000,14259639000,11216526000,9877574,674,769,710,425,599,1444,1136
2010,Minnesota,3928783000,3800000000,2370572000,3600000000,6458111000,7728783000,5970572000,5310584,740,716,446,678,1216,1455,1124
2010,Mississippi,398110000,2100000000,1903646000,1600000000,1352481000,2498110000,3503646000,2970036,134,707,641,539,455,841,1180
2010,Missouri,2154640000,3500000000,2936129000,3300000000,4613765000,5654640000,6236129000,5996231,359,584,490,550,769,943,1040
2010,Montana,585942000,800000000,174966000,200000000,714814000,1385942000,374966000,990898,591,807,177,202,721,1399,378
2010,Nebraska,1165918000,1700000000,939439000,1300000000,1514831000,2865918000,2239439000,1830429,637,929,513,710,828,1566,1223
2010,Nevada,1418024000,2100000000,1542786000,2100000000,0,3518024000,3642786000,2704642,524,776,570,776,0,1301,1347
2010,New Hampshire,2077077000,1200000000,183859000,300000000,82365000,3277077000,483859000,1316759,1577,911,140,228,63,2489,367
2010,New Jersey,15037457000,9700000000,5397733000,4900000000,10322943000,24737457000,10297733000,8801624,1708,1102,613,557,1173,2811,1170
2010,New Mexico,539106000,800000000,1176902000,1800000000,956600000,1339106000,2976902000,2065932,261,387,570,871,463,648,1441
2010,New York,21468442000,23200000000,9717101000,17900000000,42493349000,44668442000,27617101000,19392283,1107,1196,501,923,2191,2303,1424
2010,North Carolina,4908725000,3900000000,5723771000,4800000000,9133689000,8808725000,10523771000,9561558,513,408,599,502,955,921,1101
2010,North Dakota,162308000,600000000,440817000,500000000,303764000,762308000,940817000,674499,241,890,654,741,450,1130,1395
2010,Ohio,5990588000,7100000000,6246786000,6600000000,12209824000,13090588000,12846786000,11536182,519,615,541,572,1058,1135,1114
2010,Oklahoma,774768000,1600000000,2415012000,2300000000,2224783000,2374768000,4715012000,3761702,206,425,642,611,591,631,1253
2010,Oregon,2809251000,2300000000,279794000,700000000,4946443000,5109251000,979794000,3838957,732,599,73,182,1288,1331,255
2010,Pennsylvania,7117112000,9000000000,6796418000,6600000000,13405313000,16117112000,13396418000,12709630,560,708,535,519,1055,1268,1054
2010,Rhode Island,1104091000,1100000000,467029000,700000000,909674000,2204091000,1167029000,1052886,1049,1045,444,665,864,2093,1108
2010,South Carolina,1327979000,3500000000,2270517000,1600000000,2673000000,4827979000,3870517000,4636312,286,755,490,345,577,1041,835
2010,South Dakota,323600000,600000000,553131000,700000000,0,923600000,1253131000,816463,396,735,677,857,0,1131,1535
2010,Tennessee,2079525000,3000000000,5641519000,3900000000,172459000,5079525000,9541519000,6356897,327,472,887,614,27,799,1501
2010,Texas,14422037000,25300000000,13049417000,19500000000,0,39722037000,32549417000,25257114,571,1002,517,772,0,1573,1289
2010,Utah,858282000,1600000000,1640300000,1200000000,2104641000,2458282000,2840300000,2776469,309,576,591,432,758,885,1023
2010,Vermont,453200000,900000000,224788000,300000000,489107000,1353200000,524788000,625960,724,1438,359,479,781,2162,838
2010,Virginia,5085926000,6300000000,2791297000,3800000000,8659470000,11385926000,6591297000,8024617,634,785,348,474,1079,1419,821
2010,Washington,4546799000,4100000000,5660800000,9200000000,0,8646799000,14860800000,6744496,674,608,839,1364,0,1282,2203
2010,West Virginia,349779000,1100000000,872995000,1000000000,1521895000,1449779000,1872995000,1853973,189,593,471,539,821,782,1010
2010,Wisconsin,5530053000,4500000000,3552376000,2800000000,5791991000,10030053000,6352376000,5691047,972,791,624,492,1018,1762,1116
2010,Wyoming,280506000,1200000000,485651000,600000000,0,1480506000,1085651000,564460,497,2126,860,1063,0,2623,1923
2010,United States Total,194447292000,249500000000,178132164000,200100000000,261510473000,443947292000,378232164000,309349689,629,807,576,647,845,1435,1223
2011,Alabama,779837000,1800000000,2835789000,3000000000,2905023000,2579837000,5835789000,4798834,163,375,591,625,605,538,1216
2011,Alaska,647001000,800000000,416755000,100000000,0,1447001000,516755000,722038,896,1108,577,138,0,2004,716
2011,Arizona,2095486000,4900000000,5644403000,4000000000,2863658000,6995486000,9644403000,6473497,324,757,872,618,442,1081,1490
2011,Arkansas,919139000,900000000,2866361000,1700000000,2270383000,1819139000,4566361000,2940407,313,306,975,578,772,619,1553
2011,California,23813875000,29800000000,24870545000,28800000000,50508441000,53613875000,53670545000,37641823,633,792,661,765,1342,1424,1426
2011,Colorado,2428434000,4500000000,3048115000,3300000000,4540586000,6928434000,6348115000,5121771,474,879,595,644,887,1353,1239
2011,Connecticut,7138137000,2300000000,2004793000,2500000000,6469246000,9438137000,4504793000,3588023,1989,641,559,697,1803,2630,1256
2011,Delaware,405042000,300000000,123921000,200000000,1014053000,705042000,323921000,907316,446,331,137,220,1118,777,357
2011,District of Columbia,67765000,1700000000,595502000,700000000,1296598000,1767765000,1295502000,619602,109,2744,961,1130,2093,2853,2091
2011,Florida,5413654000,20500000000,14179977000,15200000000,0,25913654000,29379977000,19093352,284,1074,743,796,0,1357,1539
2011,Georgia,4204388000,6300000000,4984133000,5500000000,7658782000,10504388000,10484133000,9801578,429,643,509,561,781,1072,1070
2011,Hawaii,324771000,1000000000,1858711000,1400000000,1247291000,1324771000,3258711000,1379252,235,725,1348,1015,904,960,2363
2011,Idaho,595208000,800000000,1009446000,500000000,1169247000,1395208000,1509446000,1583828,376,505,637,316,738,881,953
2011,Illinois,11813651000,12700000000,5927273000,8600000000,11717504000,24513651000,14527273000,12867291,918,987,461,668,911,1905,1129
2011,Indiana,1062931000,5300000000,5117330000,2700000000,6176580000,6362931000,7817330000,6516045,163,813,785,414,948,977,1200
2011,Iowa,1636414000,2800000000,2261789000,1500000000,2943530000,4436414000,3761789000,3066054,534,913,738,489,960,1447,1227
2011,Kansas,1323262000,2600000000,2144472000,2000000000,2692626000,3923262000,4144472000,2869035,461,906,747,697,939,1367,1445
2011,Kentucky,1066329000,2000000000,1810786000,2600000000,4519293000,3066329000,4410786000,4369488,244,458,414,595,1034,702,1009
2011,Louisiana,1083836000,2500000000,2314805000,5300000000,2403956000,3583836000,7614805000,4575184,237,546,506,1158,525,783,1664
2011,Maine,675475000,1700000000,751023000,700000000,1420982000,2375475000,1451023000,1328150,509,1280,565,527,1070,1789,1093
2011,Maryland,6211721000,2300000000,2317480000,3400000000,10519103000,8511721000,5717480000,5838991,1064,394,397,582,1802,1458,979
2011,Massachusetts,7086932000,6200000000,3456503000,2800000000,11597152000,13286932000,6256503000,6613149,1072,938,523,423,1754,2009,946
2011,Michigan,7241709000,6400000000,7523266000,4300000000,6825555000,13641709000,11823266000,9881521,733,648,761,435,691,1381,1197
2011,Minnesota,4383815000,3800000000,2414476000,3800000000,7482396000,8183815000,6214476000,5345668,820,711,452,711,1400,1531,1163
2011,Mississippi,588587000,2000000000,1948875000,1700000000,1397578000,2588587000,3648875000,2978470,198,671,654,571,469,869,1225
2011,Missouri,2367934000,3400000000,3060746000,3300000000,4837194000,5767934000,6360746000,6009641,394,566,509,549,805,960,1058
2011,Montana,573080000,800000000,170718000,200000000,812629000,1373080000,370718000,997221,575,802,171,201,815,1377,372
2011,Nebraska,1296797000,1700000000,1060507000,1300000000,1721548000,2996797000,2360507000,1840538,705,924,576,706,935,1628,1283
2011,Nevada,1056513000,2000000000,1837518000,2200000000,0,3056513000,4037518000,2712799,389,737,677,811,0,1127,1488
2011,New Hampshire,2163181000,1200000000,87622000,400000000,75664000,3363181000,487622000,1319815,1639,909,66,303,57,2548,369
2011,New Jersey,15990467000,9600000000,5380035000,5200000000,10617034000,25590467000,10580035000,8827783,1811,1087,609,589,1203,2899,1198
2011,New Mexico,695345000,700000000,1345458000,1900000000,1096922000,1395345000,3245458000,2080395,334,336,647,913,527,671,1560
2011,New York,22946662000,22800000000,10243879000,19200000000,44525008000,45746662000,29443879000,19498514,1177,1169,525,985,2284,2346,1510
2011,North Carolina,5150293000,3800000000,5997007000,5000000000,9869492000,8950293000,10997007000,9656754,533,394,621,518,1022,927,1139
2011,North Dakota,170346000,600000000,554012000,600000000,433116000,770346000,1154012000,685136,249,876,809,876,632,1124,1684
2011,Ohio,6352951000,7000000000,6807485000,6700000000,13219230000,13352951000,13507485000,11543463,550,606,590,580,1145,1157,1170
2011,Oklahoma,757869000,1500000000,2635750000,2400000000,2385413000,2257869000,5035750000,3787821,200,396,696,634,630,596,1329
2011,Oregon,2819150000,2300000000,350735000,700000000,5493776000,5119150000,1050735000,3871728,728,594,91,181,1419,1322,271
2011,Pennsylvania,7937751000,8800000000,7418060000,7000000000,13963852000,16737751000,14418060000,12744583,623,690,582,549,1096,1313,1131
2011,Rhode Island,1184913000,1100000000,487946000,700000000,1025584000,2284913000,1187946000,1053536,1125,1044,463,664,973,2169,1128
2011,South Carolina,1405415000,3400000000,2273253000,1700000000,2907731000,4805415000,3973253000,4671422,301,728,487,364,622,1029,851
2011,South Dakota,378122000,600000000,527644000,800000000,0,978122000,1327644000,823484,459,729,641,971,0,1188,1612
2011,Tennessee,2152485000,3000000000,5587525000,4100000000,189518000,5152485000,9687525000,6397410,336,469,873,641,30,805,1514
2011,Texas,15011473000,25000000000,13780157000,20900000000,0,40011473000,34680157000,25646227,585,975,537,815,0,1560,1352
2011,Utah,1092217000,1600000000,1870918000,1300000000,2298220000,2692217000,3170918000,2814216,388,569,665,462,817,957,1127
2011,Vermont,475067000,900000000,148634000,400000000,556013000,1375067000,548634000,626979,758,1435,237,638,887,2193,875
2011,Virginia,5109570000,6300000000,2740267000,3800000000,9530628000,11409570000,6540267000,8100469,631,778,338,469,1177,1409,807
2011,Washington,4860271000,4100000000,6283168000,9800000000,0,8960271000,16083168000,6821655,712,601,921,1437,0,1314,2358
2011,West Virginia,329467000,1100000000,833905000,1100000000,1665885000,1429467000,1933905000,1856074,178,593,449,593,898,770,1042
2011,Wisconsin,5556076000,4500000000,3513079000,3000000000,6429115000,10056076000,6513079000,5704755,974,789,616,526,1127,1763,1142
2011,Wyoming,130422000,1100000000,469804000,700000000,0,1230422000,1169804000,567224,230,1939,828,1234,0,2169,2062
2011,United States Total,200871236000,244900000000,187892361000,210700000000,285293135000,445771236000,398592361000,311580009,645,786,603,676,916,1431,1279
2015,Alabama,579687000,2000000000,3152554000,3200000000,3450713000,2579687000,6352554000,4853160,119,412,650,659,711,532,1309
2015,Alaska,676062000,800000000,330413000,100000000,0,1476062000,430413000,737547,917,1085,448,136,0,2001,584
2015,Arizona,2010100000,5000000000,5636143000,5000000000,3760883000,7010100000,10636143000,6833596,294,732,825,732,550,1026,1556
2015,Arkansas,972031000,1100000000,3058839000,2100000000,2664153000,2072031000,5158839000,2978407,326,369,1027,705,894,696,1732
2015,California,27364451000,29600000000,30597305000,30600000000,77929551000,56964451000,61197305000,38953142,702,760,785,786,2001,1462,1571
2015,Colorado,2237267000,5100000000,3433893000,4100000000,6360629000,7337267000,7533893000,5452107,410,935,630,752,1167,1346,1382
2015,Connecticut,7719905000,2500000000,2667242000,2600000000,8182071000,10219905000,5267242000,3587509,2152,697,743,725,2281,2849,1468
2015,Delaware,408922000,400000000,1976000,300000000,1198140000,808922000,301976000,941413,434,425,2,319,1273,859,321
2015,District of Columbia,351724000,1900000000,680974000,900000000,1868468000,2251724000,1580974000,675254,521,2814,1008,1333,2767,3335,2341
2015,Florida,9296044000,15200000000,18144543000,15300000000,0,24496044000,33444543000,20224249,460,752,897,757,0,1211,1654
2015,Georgia,5059170000,6400000000,5298010000,5800000000,9678524000,11459170000,11098010000,10181111,497,629,520,570,951,1126,1090
2015,Hawaii,531270000,1000000000,1885140000,2000000000,1987915000,1531270000,3885140000,1422484,373,703,1325,1406,1397,1076,2731
2015,Idaho,656071000,900000000,1122464000,700000000,1478368000,1556071000,1822464000,1651523,397,545,680,424,895,942,1104
2015,Illinois,12607019000,13800000000,9310732000,9300000000,15913816000,26407019000,18610732000,12864342,980,1073,724,723,1237,2053,1447
2015,Indiana,1904371000,4500000000,5110215000,3800000000,6555597000,6404371000,8910215000,6608296,288,681,773,575,992,969,1348
2015,Iowa,1847311000,3000000000,2358621000,2000000000,3575849000,4847311000,4358621000,3121460,592,961,756,641,1146,1553,1396
2015,Kansas,1188477000,3000000000,2708319000,2200000000,2264875000,4188477000,4908319000,2909502,408,1031,931,756,778,1440,1687
2015,Kentucky,1239632000,2100000000,1887259000,3000000000,5367266000,3339632000,4887259000,4425999,280,474,426,678,1213,755,1104
2015,Louisiana,1047462000,3000000000,4199182000,3900000000,2983104000,4047462000,8099182000,4664851,225,643,900,836,639,868,1736
2015,Maine,875931000,1800000000,919339000,800000000,1533130000,2675931000,1719339000,1328484,659,1355,692,602,1154,2014,1294
2015,Maryland,6842590000,2500000000,2204268000,4200000000,13215473000,9342590000,6404268000,5986717,1143,418,368,702,2207,1561,1070
2015,Massachusetts,8743269000,6600000000,3411707000,3900000000,14491903000,15343269000,7311707000,6795891,1287,971,502,574,2132,2258,1076
2015,Michigan,7928149000,5700000000,6727466000,4700000000,9306942000,13628149000,11427466000,9932573,798,574,677,473,937,1372,1151
2015,Minnesota,4068329000,4300000000,2777916000,4600000000,10370047000,8368329000,7377916000,5482503,742,784,507,839,1891,1526,1346
2015,Mississippi,753669000,2100000000,2011877000,2100000000,1783438000,2853669000,4111877000,2988693,252,703,673,703,597,955,1376
2015,Missouri,2455567000,3400000000,3982472000,3100000000,6233008000,5855567000,7082472000,6071745,404,560,656,511,1027,964,1166
2015,Montana,657043000,900000000,92734000,300000000,1180478000,1557043000,392734000,1030503,638,873,90,291,1146,1511,381
2015,Nebraska,1513157000,2000000000,1414721000,1300000000,2239582000,3513157000,2714721000,1891507,800,1057,748,687,1184,1857,1435
2015,Nevada,1273918000,1500000000,2523251000,3100000000,0,2773918000,5623251000,2868666,444,523,880,1081,0,967,1960
2015,New Hampshire,2793508000,1300000000,62160000,400000000,96038000,4093508000,462160000,1336294,2090,973,47,299,72,3063,346
2015,New Jersey,16340789000,11200000000,5366840000,6200000000,13250002000,27540789000,11566840000,8870869,1842,1263,605,699,1494,3105,1304
2015,New Mexico,703402000,900000000,1189322000,2500000000,1381254000,1603402000,3689322000,2090211,337,431,569,1196,661,767,1765
2015,New York,24556824000,28300000000,15233759000,18600000000,55201239000,52856824000,33833759000,19661411,1249,1439,775,946,2808,2688,1721
2015,North Carolina,5565377000,4000000000,6533597000,5600000000,11197650000,9565377000,12133597000,10033079,555,399,651,558,1116,953,1209
2015,North Dakota,308388000,600000000,863931000,1100000000,536131000,908388000,1963931000,754022,409,796,1146,1459,711,1205,2605
2015,Ohio,7392163000,6900000000,10350561000,7800000000,13795229000,14292163000,18150561000,11617850,636,594,891,671,1187,1230,1562
2015,Oklahoma,1128899000,1500000000,2757153000,3100000000,3252290000,2628899000,5857153000,3909831,289,384,705,793,832,672,1498
2015,Oregon,3223759000,2400000000,276638000,900000000,7309147000,5623759000,1176638000,4016918,803,597,69,224,1820,1400,293
2015,Pennsylvania,9217452000,9200000000,7979410000,8100000000,16337896000,18417452000,16079410000,12785759,721,720,624,634,1278,1440,1258
2015,Rhode Island,1269875000,1200000000,508124000,800000000,1215368000,2469875000,1308124000,1056173,1202,1136,481,757,1151,2339,1239
2015,South Carolina,1676778000,3800000000,2589073000,2300000000,3695701000,5476778000,4889073000,4892253,343,777,529,470,755,1119,999
2015,South Dakota,464503000,700000000,571396000,1000000000,0,1164503000,1571396000,853933,544,820,669,1171,0,1364,1840
2015,Tennessee,2493601000,3200000000,5285629000,5100000000,302196000,5693601000,10385629000,6590808,378,486,802,774,46,864,1576
2015,Texas,18266991000,29300000000,22226767000,26900000000,0,47566991000,49126767000,27486814,665,1066,809,979,0,1731,1787
2015,Utah,1097955000,1800000000,1787617000,1600000000,3157718000,2897955000,3387617000,2982497,368,604,599,536,1059,972,1136
2015,Vermont,491297000,1100000000,86272000,500000000,709310000,1591297000,586272000,625197,786,1759,138,800,1135,2545,938
2015,Virginia,6100823000,6600000000,2850731000,4300000000,11903945000,12700823000,7150731000,8362907,730,789,341,514,1423,1519,855
2015,Washington,5370467000,4700000000,9206242000,9800000000,0,10070467000,19006242000,7163543,750,656,1285,1368,0,1406,2653
2015,West Virginia,415228000,1200000000,853734000,1200000000,1932457000,1615228000,2053734000,1841996,225,651,463,651,1049,877,1115
2015,Wisconsin,4282567000,5000000000,3988064000,3400000000,7069248000,9282567000,7388064000,5761406,743,868,692,590,1227,1611,1282
2015,Wyoming,381465000,1000000000,524256000,700000000,0,1381465000,1224256000,585668,651,1707,895,1195,0,2359,2090
2015,United States Total,226250709000,258100000000,228640851000,237000000000,367916742000,484350709000,465640851000,320742673,705,805,713,739,1147,1510,1452
2016,Alabama,664939000,2000000000,3328586000,3300000000,3612433000,2664939000,6628586000,4864745,137,411,684,678,743,548,1363
2016,Alaska,517902000,1000000000,343646000,100000000,0,1517902000,443646000,741504,698,1349,463,135,0,2047,598
2016,Arizona,2135486000,5200000000,5794590000,5300000000,3967924000,7335486000,11094590000,6945452,307,749,834,763,571,1056,1597
2016,Arkansas,926572000,1200000000,3154949000,2200000000,2781458000,2126572000,5354949000,2990410,310,401,1055,736,930,711,1791
2016,California,32066035000,29200000000,30806592000,31600000000,80753345000,61266035000,62406592000,39209127,818,745,786,806,2060,1563,1592
2016,Colorado,2479825000,5400000000,3958488000,3900000000,6485602000,7879825000,7858488000,5540921,448,975,714,704,1170,1422,1418
2016,Connecticut,7801407000,2700000000,2426468000,2500000000,7557153000,10501407000,4926468000,3578674,2180,754,678,699,2112,2934,1377
2016,Delaware,319763000,500000000,17290000,300000000,1169922000,819763000,317290000,949216,337,527,18,316,1233,864,334
2016,District of Columbia,318896000,2100000000,691941000,900000000,1907862000,2418896000,1591941000,686575,464,3059,1008,1311,2779,3523,2319
2016,Florida,9798485000,16300000000,18772533000,15200000000,0,26098485000,33972533000,20629982,475,790,910,737,0,1265,1647
2016,Georgia,4657637000,7300000000,5333448000,6300000000,10439534000,11957637000,11633448000,10304763,452,708,518,611,1013,1160,1129
2016,Hawaii,829213000,800000000,1876672000,2200000000,2116130000,1629213000,4076672000,1428105,581,560,1314,1541,1482,1141,2855
2016,Idaho,686295000,900000000,1197087000,800000000,1521238000,1586295000,1997087000,1682930,408,535,711,475,904,943,1187
2016,Illinois,12110946000,15100000000,9372588000,10150000000,13806525000,27210946000,19522588000,12826895,944,1177,731,791,1076,2121,1522
2016,Indiana,1717679000,4700000000,5222776000,3700000000,6539377000,6417679000,8922776000,6633344,259,709,787,558,986,967,1345
2016,Iowa,1953594000,3000000000,2456597000,2200000000,3656375000,4953594000,4656597000,3131785,624,958,784,702,1168,1582,1487
2016,Kansas,1231278000,3100000000,2649380000,2500000000,2233626000,4331278000,5149380000,2911263,423,1065,910,859,767,1488,1769
2016,Kentucky,1137591000,2300000000,1775927000,3200000000,5639966000,3437591000,4975927000,4438229,256,518,400,721,1271,775,1121
2016,Louisiana,1054951000,3100000000,4561554000,3900000000,2866456000,4154951000,8461554000,4678215,226,663,975,834,613,888,1809
2016,Maine,799804000,2000000000,992765000,800000000,1551637000,2799804000,1792765000,1331370,601,1502,746,601,1165,2103,1347
2016,Maryland,5919099000,3400000000,2139395000,4400000000,13710859000,9319099000,6539395000,6004692,986,566,356,733,2283,1552,1089
2016,Massachusetts,7985279000,8100000000,3505576000,4100000000,14430331000,16085279000,7605576000,6826022,1170,1187,514,601,2114,2356,1114
2016,Michigan,7939225000,6100000000,6584068000,4800000000,9797553000,14039225000,11384068000,9951890,798,613,662,482,984,1411,1144
2016,Minnesota,4658731000,4000000000,2705009000,4800000000,10732570000,8658731000,7505009000,5523409,843,724,490,869,1943,1568,1359
2016,Mississippi,749828000,2200000000,2003127000,2000000000,1800053000,2949828000,4003127000,2988298,251,736,670,669,602,987,1340
2016,Missouri,2516722000,3400000000,4190498000,3200000000,6413681000,5916722000,7390498000,6087203,413,559,688,526,1054,972,1214
2016,Montana,578300000,1000000000,148274000,200000000,1181042000,1578300000,348274000,1040863,556,961,142,192,1135,1516,335
2016,Nebraska,1342245000,2300000000,1338767000,1400000000,2244719000,3642245000,2738767000,1905924,704,1207,702,735,1178,1911,1437
2016,Nevada,1423029000,1500000000,2657113000,3300000000,0,2923029000,5957113000,2919772,487,514,910,1130,0,1001,2040
2016,New Hampshire,2559186000,1600000000,45745000,400000000,87973000,4159186000,445745000,1342373,1906,1192,34,298,66,3098,332
2016,New Jersey,15278904000,12800000000,5275069000,6400000000,13355992000,28078904000,11675069000,8874516,1722,1442,594,721,1505,3164,1316
2016,New Mexico,702481000,900000000,1117608000,2400000000,1409811000,1602481000,3517608000,2092789,336,430,534,1147,674,766,1681
2016,New York,22876119000,32300000000,15113312000,19600000000,58102548000,55176119000,34713312000,19641589,1165,1644,769,998,2958,2809,1767
2016,North Carolina,4806032000,5100000000,6789623000,5900000000,12042957000,9906032000,12689623000,10156679,473,502,668,581,1186,975,1249
2016,North Dakota,379445000,600000000,674665000,900000000,351125000,979445000,1574665000,754353,503,795,894,1193,465,1298,2087
2016,Ohio,7389729000,7300000000,10519941000,8300000000,13322598000,14689729000,18819941000,11635003,635,627,904,713,1145,1263,1618
2016,Oklahoma,1141393000,1600000000,2793727000,2800000000,2996870000,2741393000,5593727000,3926769,291,407,711,713,763,698,1425
2016,Oregon,3201314000,2700000000,214257000,1000000000,7690034000,5901314000,1214257000,4091404,782,660,52,244,1880,1442,297
2016,Pennsylvania,8394224000,10500000000,8307798000,8500000000,16915827000,18894224000,16807798000,12783538,657,821,650,665,1323,1478,1315
2016,Rhode Island,1354186000,1200000000,532390000,800000000,1236194000,2554186000,1332390000,1057063,1281,1135,504,757,1169,2416,1260
2016,South Carolina,1872550000,3900000000,2431399000,2200000000,3869342000,5772550000,4631399000,4958235,378,787,490,444,780,1164,934
2016,South Dakota,501255000,700000000,621776000,1000000000,0,1201255000,1621776000,862890,581,811,721,1159,0,1392,1879
2016,Tennessee,1959994000,3600000000,5336821000,5500000000,323952000,5559994000,10836821000,6645011,295,542,803,828,49,837,1631
2016,Texas,17767498000,31400000000,21048467000,26800000000,0,49167498000,47848467000,27937492,636,1124,753,959,0,1760,1713
2016,Utah,1100857000,2000000000,1952000000,1700000000,3374535000,3100857000,3652000000,3042613,362,657,642,559,1109,1019,1200
2016,Vermont,516283000,1100000000,78771000,500000000,729986000,1616283000,578771000,623644,828,1764,126,802,1171,2592,928
2016,Virginia,5601233000,7400000000,2920772000,4500000000,12237996000,13001233000,7420772000,8410946,666,880,347,535,1455,1546,882
2016,Washington,5458113000,5000000000,12725942000,7900000000,0,10458113000,20625942000,7294680,748,685,1745,1083,0,1434,2828
2016,West Virginia,473725000,1200000000,794444000,1200000000,1845711000,1673725000,1994444000,1830929,259,655,434,655,1008,914,1089
2016,Wisconsin,4406961000,5000000000,4240021000,3300000000,7486676000,9406961000,7540021000,5772958,763,866,734,572,1297,1629,1306
2016,Wyoming,1099911000,300000000,487438000,500000000,0,1399911000,987438000,584290,1882,513,834,856,0,2396,1690
2016,United States Total,225162149000,278100000000,234377690000,241000000000,376297498000,503262149000,475377690000,323071342,697,861,725,746,1165,1558,1471
